//MAP CONVERTED BY dmm2tgm.py THIS HEADER COMMENT PREVENTS RECONVERSION, DO NOT REMOVE
"a" = (
/turf/closed/wall/vampwall/rock,
/area/vtm/interior/sewer)
"c" = (
/obj/structure/flora/rock/stalagmite,
/turf/open/floor/plating/rough/cave,
/area/vtm/interior/sewer)
"d" = (
/obj/structure/flora/bush/sparsegrass/style_random,
/turf/open/misc/dirt,
/area/vtm/interior/sewer)
"f" = (
/obj/effect/spawner/random/trash/grime,
/turf/open/floor/plating/rough/cave,
/area/vtm/interior/sewer)
"g" = (
/mob/living/basic/gangrel/best/hostile,
/turf/open/floor/plating/rough/cave,
/area/vtm/interior/sewer)
"i" = (
/turf/open/water/vamp_sewer,
/area/vtm/interior/sewer)
"j" = (
/turf/open/floor/plating/rough/cave,
/area/vtm/interior/sewer)
"k" = (
/obj/structure/flora/bush/style_random,
/turf/open/misc/dirt,
/area/vtm/interior/sewer)
"l" = (
/mob/living/basic/gangrel/hostile,
/turf/open/floor/plating/rough/cave,
/area/vtm/interior/sewer)
"m" = (
/obj/structure/flora/bush/large/style_random,
/turf/open/misc/dirt,
/area/vtm/interior/sewer)
"n" = (
/obj/structure/flora/rock/stalagmite,
/turf/open/floor/plating/stone,
/area/vtm/interior/sewer)
"q" = (
/turf/open/floor/plating/stone,
/area/vtm/interior/sewer)
"r" = (
/obj/structure/table/wood,
/obj/item/spear/military,
/turf/open/floor/plating/rough/cave,
/area/vtm/interior/sewer)
"s" = (
/obj/effect/spawner/random/trash/graffiti,
/turf/open/floor/plating/rough/cave,
/area/vtm/interior/sewer)
"t" = (
/obj/structure/flora/bush/sparsegrass/style_random,
/obj/structure/flora/bush/large/style_random,
/turf/open/misc/dirt,
/area/vtm/interior/sewer)
"u" = (
/obj/structure/table/wood,
/obj/item/storage/toolbox/fishing,
/obj/item/fish/darkpack/shark,
/obj/item/storage/backpack/duffelbag,
/turf/open/floor/plating/rough/cave,
/area/vtm/interior/sewer)
"A" = (
/obj/structure/table/wood,
/obj/item/storage/cans/sixbeer,
/turf/open/floor/plating/rough/cave,
/area/vtm/interior/sewer)
"E" = (
/turf/open/misc/dirt,
/area/vtm/interior/sewer)
"F" = (
/obj/structure/chair/plastic/darkpack,
/turf/open/floor/plating/rough/cave,
/area/vtm/interior/sewer)
"H" = (
/mob/living/basic/bat,
/turf/open/floor/plating/rough/cave,
/area/vtm/interior/sewer)
"J" = (
/obj/structure/headpike/military,
/turf/open/floor/plating/rough/cave,
/area/vtm/interior/sewer)
"K" = (
/obj/structure/bonfire/prelit/alt,
/turf/open/floor/plating/stone,
/area/vtm/interior/sewer)
"L" = (
/obj/effect/spawner/random/trash/cigbutt,
/turf/open/floor/plating/rough/cave,
/area/vtm/interior/sewer)
"O" = (
/obj/effect/spawner/random/trash/cigpack,
/turf/open/floor/plating/stone,
/area/vtm/interior/sewer)
"P" = (
/obj/modular_map_connector,
/turf/open/misc/dirt,
/area/vtm/interior/sewer)
"V" = (
/obj/effect/spawner/random/trash/crushed_can,
/turf/open/floor/plating/stone,
/area/vtm/interior/sewer)
"Y" = (
/obj/effect/spawner/random/trash/crushed_can,
/turf/open/floor/plating/rough/cave,
/area/vtm/interior/sewer)

(1,1,1) = {"
a
a
a
a
a
a
a
a
a
a
a
a
a
a
a
a
a
a
a
P
"}
(2,1,1) = {"
a
a
a
a
a
a
a
a
a
a
a
a
a
a
a
a
a
a
a
E
"}
(3,1,1) = {"
a
a
a
a
a
i
i
a
a
a
O
q
a
a
a
a
a
a
a
E
"}
(4,1,1) = {"
a
a
a
q
i
i
i
a
a
L
q
q
q
a
a
a
a
a
a
E
"}
(5,1,1) = {"
a
a
K
q
F
i
a
a
V
j
j
j
j
j
a
q
j
j
q
E
"}
(6,1,1) = {"
a
n
q
j
u
a
a
L
q
q
Y
j
j
j
j
j
j
j
j
E
"}
(7,1,1) = {"
a
g
j
j
a
a
c
j
j
j
a
a
j
j
j
q
q
a
a
E
"}
(8,1,1) = {"
a
j
j
j
a
a
s
q
j
a
a
a
a
a
a
a
a
a
a
E
"}
(9,1,1) = {"
a
j
j
a
a
a
J
q
j
a
a
a
a
a
a
a
a
a
a
E
"}
(10,1,1) = {"
a
j
F
r
a
a
a
j
j
j
j
j
q
m
k
a
a
a
a
E
"}
(11,1,1) = {"
a
j
j
A
a
a
H
j
j
j
j
j
j
q
k
t
a
a
a
E
"}
(12,1,1) = {"
a
F
q
c
a
a
a
q
j
j
a
a
f
j
j
d
a
a
a
E
"}
(13,1,1) = {"
a
q
q
q
a
a
a
H
a
a
a
a
a
j
q
E
a
a
a
E
"}
(14,1,1) = {"
a
q
j
q
l
a
a
a
a
a
a
a
j
q
q
m
a
a
a
E
"}
(15,1,1) = {"
a
a
j
j
j
a
a
a
a
a
a
j
j
j
d
a
a
a
a
E
"}
(16,1,1) = {"
a
a
a
j
j
j
j
a
a
j
j
j
j
d
t
a
a
a
a
E
"}
(17,1,1) = {"
a
a
a
j
j
j
j
j
j
j
j
j
a
a
a
a
a
a
a
E
"}
(18,1,1) = {"
a
a
a
a
c
j
j
j
q
q
q
a
a
a
a
a
a
a
a
E
"}
(19,1,1) = {"
a
a
a
a
a
a
a
a
a
a
a
a
a
a
a
a
a
a
a
E
"}
(20,1,1) = {"
a
a
a
a
a
a
a
a
a
a
a
a
a
a
a
a
a
a
a
E
"}
